1 - CHECK POINT
2- game over
3 - voltar sprite qdo o chão acabar
4 - parametrizar o barquinho


SPRITE OGRO

SPRITE
M = 3 , 4 , 5 (POSICAO DO SPRITE)

IN%(J,0) = 'COLUNA
IN%(J,1) = 'LINHA
IN%(J,2) = 'DIREÇÃO
IN%(J,3) = 'NRO DO SPRITE
IN%(J,4) = 'NRO DO SPRITE TROCA
IN%(J,5) = 'COR
																					  |ESTACA.......|
																					   PC%		 PD%	 
0 1 2 3 4 5    6  7  8       9  10    11,12,13     14,15,16		17,18,19      20      ,21	,22	,23	
			 LINHA	       COLUNA  	  COR          DIRECAO		SPRITE		  CHAR    , X   ,Y	,QTD 
0,2,0,0,0,   10,15,19,     26,29,2,   4,5,6       ,1,1,1,	 	33,27,33	  134	  , 15	,20	,3
			|**********************************|
					OGRO


0,2,0,0,0,10,15,19,26,29,2,7,9 ,3,1,1,1,33,27,33,201,15,20,0
1,3,0,0,1,0 ,15,0 ,0 ,9 ,0,0,15,0,0,0,0,0 ,27,0 ,201,15,20,0
					   0 1 2  3	4 5 6 7  8  9 0   1 2 3
0 1 2 3 4 5  6  7 8  9 1 1 1  1 1 1 1 1  1  1 2   2 2 2
1,3,0,0,1,0 ,15,0,0 ,9,0,0,15,0,0,0,0,0 ,27,0,134,5 ,20,2

2,4,0,0,1,10,0 ,0,23,0,0,2,0 ,0,0,0,0,33,0 ,0,0  ,10,20,1


2,4,0,0,1,10,0 ,0,23,0,0,2,0 ,0,0,0,0,33,0 ,0,0  ,10,20,1